{
    "1": {
        "field": [
            [0, 0, 1, 1, 1, 0, 0, 0],
            [0, 0, 1, 2, 1, 0, 0, 0],
            [0, 0, 1, 2, 1, 1, 1, 1],
            [1, 1, 1, 2, 2, 2, 2, 1],
            [1, 2, 2, 2, 2, 1, 1, 1],
            [1, 1, 1, 1, 2, 1, 0, 0],
            [0, 0, 0, 1, 2, 1, 0, 0],
            [0, 0, 0, 1, 1, 1, 0, 0]
        ],
        "player": [4, 4],
        "boxes": [[3, 3], [4, 3], [3, 4], [4, 5]],
        "targets": [[3, 1], [6, 3], [1, 4], [4, 6]]
    }
}